the — артикль (определенный)
be — быть
to — к (предлог), чтобы (союз)
of — из, о, от
and — и
a — артикль (неопределенный)
in — в
that — что, тот, та, то
have — иметь
I — я
it — это, оно
for — для, за
not — не
on — на
with — с
he — он
as — как
you — ты, вы
do — делать
at — у, при
this — этот, эта, это
but — но
his — его
by — к, по, через
from — из, от
they — они
we — мы
say — сказать
her — ее
she — она
or — или
an — артикль (неопределенный)
will — будет, воля
my — мой
one — один
all — все
would — бы, будет
there — там
their — их
what — что
so — так, таким образом
up — вверх
out — из, снаружи
if — если
about — о, около
who — кто
get — получать
which — который
go — идти
me — мне, меня
when — когда
make — делать
can — мочь
like — как, нравиться
time — время
no — нет
just — только, просто
him — его
know — знать
take — брать
people — люди
into — в
year — год
your — ваш
good — хороший
some — некоторые
could — мог бы
them — их
see — видеть
other — другой
than — чем
then — затем, тогда
now — сейчас
look — смотреть
only — только
come — приходить
its — его, ее (притяжательное)
over — над, через
think — думать
also — также
back — назад
after — после
use — использовать
two — два
how — как
our — наш
work — работа
first — первый
well — хорошо
way — путь, способ
even — даже
new — новый
want — хотеть
because — потому что
any — любой
these — эти
give — давать
day — день
most — большинство, наиболее
us — нас, нам